1
---PPP---
---PCP---
---PPP---
PPPD-DPPP
PCP-0-PCP
PPPD--PPP
---PPP---
---PCP---
---PPP---
