2
-----------------
---PPP-----PPP---
----P------PDP---
----P------PPP---
----P------P-----
----P------P-----
---------P-------
--------PP-------
-------PIP--C----
------P--P-------
------PPPPP------
---------P-------
-----------------
-----------------
-----------------
-----------------
-----------------
