0
-----------------
--P--P--PPPP-PPP-
-P-P-P--P----P-P-
-PPP-P--P-PP-P-P-
-P-P-P--P--P-P-P-
-P-P-PP-PPPP-PPP-
-----------------
-------PP--------
------P-IP-------
-----P----P------
---------P-------
--------P--------
-------P---------
------P----------
-----P------DC---
-----PPPPPP------
-----------------
