0
--PPPPP-
PPP---P-
PDIC--P-
PPP-CDP-
PDPPC-P-
P-P-D-PP
PC-2CCDP
P---D--P
PPPPPPPP
